19 20
9 9 9 9 3 9 9 9 9 3 9 9 9 9 3 9 9 9 9
9 9 9 9 9 9 9 9 9 9 9 9 9 9 9 9 9 9 9
9 9 9 9 3 9 9 9 9 3 9 9 9 9 3 9 9 9 9
9 9 9 9 9 9 9 9 9 9 9 9 9 9 9 9 9 9 9
6 6 6 6 3 6 6 6 6 16 7 6 6 6 3 6 6 7 6
29 29 29 29 29 29 29 29 29 29 29 29 29 29 29 29 29 29 29
29 29 29 29 29 29 29 29 29 29 29 29 29 29 29 29 29 29 29
25 25 25 25 25 25 25 25 29 29 29 29 29 29 29 29 29 29 29
25 25 25 25 25 25 25 25 25 29 29 29 29 29 29 29 29 29 29
25 25 25 25 25 25 25 25 25 25 29 29 29 29 29 29 29 29 29
25 25 25 25 25 25 25 25 25 25 29 29 29 29 29 29 29 29 29
25 25 25 25 25 25 25 25 25 25 29 29 29 29 29 29 29 29 29
25 25 25 25 25 25 25 25 25 25 29 29 29 29 29 29 29 29 29
25 25 25 25 25 25 25 25 25 25 29 29 29 29 29 29 29 29 29
25 25 25 25 25 25 25 25 25 25 29 29 29 29 29 29 29 29 29
25 25 25 25 25 25 25 25 25 25 29 29 29 29 29 29 29 29 29
25 25 25 25 25 25 25 25 25 25 29 29 29 29 29 29 29 29 29
25 25 25 25 25 25 25 25 25 25 29 29 29 29 29 29 29 29 29
25 25 25 25 25 25 25 25 25 25 29 29 29 29 29 29 29 29 29
25 25 25 25 25 25 25 25 25 29 29 29 29 29 29 29 29 29 29