19 20
0 0 0 0 9 0 0 0 0 8 0 0 0 0 5 0 0 0 0
0 0 0 0 0 0 0 0 0 0 0 0 0 0 0 0 0 0 0
0 0 0 0 13 0 0 0 0 8 0 0 0 0 7 0 0 0 0
0 0 0 0 0 0 0 0 0 3 0 0 0 0 0 0 0 0 0
0 12 0 0 14 0 10 0 0 15 1 0 0 0 6 0 0 11 0
28 28 28 28 28 28 28 28 28 28 28 28 28 28 28 28 28 28 28
30 28 28 28 30 28 28 28 28 28 28 28 28 28 28 28 28 28 28
22 22 22 22 22 22 22 22 36 28 28 28 28 28 28 28 28 28 28
22 22 22 22 22 22 22 22 22 35 28 28 28 28 28 28 28 28 28
22 22 22 22 22 22 22 22 22 22 35 28 28 28 28 28 28 28 28
22 22 22 22 22 22 22 22 22 22 31 28 28 28 28 28 28 28 28
22 22 22 22 22 22 22 22 22 22 31 28 28 28 28 28 28 28 28
22 22 22 22 22 22 22 22 22 22 31 28 28 28 28 28 28 28 28
22 22 22 21 22 22 22 22 22 22 31 28 28 28 28 28 28 28 28
22 22 22 22 22 22 22 22 22 22 31 28 28 28 28 28 28 40 28
22 22 22 22 22 22 22 22 22 22 31 28 28 28 28 28 40 38 40
22 22 22 22 22 22 22 22 22 22 31 28 28 28 28 28 28 40 28
22 22 22 22 22 22 22 22 22 22 31 28 28 28 28 28 28 28 28
22 22 22 22 22 22 22 22 22 22 31 28 28 28 28 28 28 28 28
22 22 22 22 22 22 22 22 22 31 28 28 28 28 28 28 28 28 28