40 20
12 12 12 12 12 12 12 12 12 12 12 12 12 12 12 12 12 12 12 12 12 12 12 12 12 12 12 12 12 12 12 12 12 12 12 12 12 12 12 12
12 0 27 25 29 0 0 0 0 0 0 0 0 0 0 0 0 0 3 0 2 0 1 0 0 0 0 0 0 0 0 0 0 0 0 0 0 0 0 12
12 0 6 6 6 0 12 12 12 12 12 0 12 12 12 12 12 0 4 6 23 6 7 0 12 12 12 12 12 0 12 12 12 12 12 0 0 0 0 12
12 0 6 6 6 0 12 12 12 12 12 0 12 12 12 12 12 0 5 6 6 6 8 0 12 12 12 12 12 0 12 12 12 12 12 0 0 0 0 12
12 0 6 6 6 0 12 12 12 12 12 0 12 12 12 12 12 0 11 6 6 6 30 0 12 12 12 12 12 0 12 12 12 12 12 0 0 0 0 12
12 0 6 6 6 0 12 12 12 12 12 0 12 12 12 12 12 0 6 6 6 6 6 0 12 12 12 12 12 0 12 12 12 12 12 0 0 0 0 12
12 0 6 6 6 0 12 12 12 12 12 0 12 12 12 12 12 0 6 6 6 6 6 0 12 12 12 12 12 0 12 12 12 12 12 0 0 0 0 12
12 0 6 6 6 0 12 12 12 12 12 0 12 12 12 12 12 0 6 6 6 6 6 0 12 12 12 12 12 0 12 12 12 12 12 0 0 0 0 12
12 0 6 6 6 0 12 12 12 12 12 0 12 12 12 12 12 0 6 6 6 6 6 0 12 12 12 12 12 0 12 12 12 12 12 0 0 0 0 12
12 0 6 6 6 0 12 12 12 12 12 0 12 12 12 12 12 0 9 6 6 6 10 0 12 12 12 12 12 0 12 12 12 12 12 0 0 0 0 12
12 0 0 24 6 0 0 0 19 0 0 0 0 0 17 0 0 0 0 0 6 0 0 0 0 0 16 0 0 0 0 0 14 0 0 0 0 0 0 12
12 0 6 6 6 6 6 20 6 6 6 6 6 6 6 6 6 6 6 6 6 6 6 6 6 6 6 6 6 6 6 6 6 6 6 6 6 6 0 12
12 0 22 22 6 6 6 6 6 6 6 6 6 6 6 6 6 6 6 6 6 6 6 6 6 6 6 6 6 6 6 6 6 6 6 6 6 6 0 12
12 0 6 6 6 6 6 6 6 6 6 6 6 6 6 6 6 6 6 6 6 6 6 6 6 6 6 6 6 6 6 6 6 6 6 6 6 21 0 12
12 0 22 22 6 6 6 6 6 6 6 6 6 6 6 6 6 6 6 6 6 6 6 6 6 6 6 6 6 6 6 6 6 6 6 6 6 6 13 12
12 0 6 6 6 6 6 6 6 6 6 6 6 6 6 6 6 6 6 6 6 6 6 6 6 6 6 6 6 6 6 6 6 6 6 6 6 6 0 12
12 0 22 22 6 6 6 6 6 6 6 6 6 6 6 6 6 6 6 6 6 6 6 6 6 6 6 6 6 6 6 6 6 6 6 6 6 6 0 12
12 0 6 6 6 6 6 6 6 6 6 6 6 6 6 6 6 6 6 6 6 6 6 6 6 6 6 6 6 6 6 6 6 6 6 6 6 6 0 12
12 0 0 0 0 0 0 0 0 15 0 0 0 0 0 0 0 15 0 0 0 0 0 0 18 0 0 0 0 0 0 0 0 18 0 0 6 0 0 12
12 12 12 12 12 12 12 12 12 12 12 12 12 12 12 12 12 12 12 12 12 12 12 12 12 12 12 12 12 12 12 12 12 12 12 12 12 12 12 12