25 20
9 9 9 9 3 9 9 9 9 3 9 9 9 9 3 9 9 9 9 17 17 17 17 17 17
9 9 9 9 9 9 9 9 9 9 9 9 9 9 9 9 9 9 9 17 17 17 17 17 17
9 9 9 9 3 9 9 9 9 3 9 9 9 9 3 9 9 9 9 17 17 17 17 17 17
9 9 9 9 9 9 9 9 9 9 9 9 9 9 9 9 9 9 9 17 17 17 17 17 17
6 6 6 6 3 6 6 6 6 16 7 6 6 6 3 6 6 7 6 17 17 17 17 17 17
22 22 22 22 22 22 22 22 22 22 22 22 22 22 22 22 22 22 22 17 17 17 17 17 17
22 22 22 22 22 22 22 22 22 22 22 22 22 22 22 22 22 22 22 17 17 17 17 17 17
25 25 25 25 25 25 25 25 22 22 22 22 22 22 22 22 22 22 22 17 17 17 17 17 17
25 25 25 25 25 25 25 25 25 22 22 22 22 22 22 22 22 22 22 17 17 17 17 17 17
25 25 25 25 25 25 25 25 25 25 22 22 22 22 22 22 22 22 22 17 17 17 17 17 17
25 25 25 25 25 25 25 25 25 25 22 22 22 22 22 22 22 22 22 17 17 17 17 17 17
25 25 25 25 25 25 25 25 25 25 22 22 22 22 22 22 22 22 22 29 29 29 29 29 29
25 25 25 25 25 25 25 25 25 25 22 22 22 22 22 22 22 22 22 29 29 29 29 29 29
25 25 25 25 25 25 25 25 25 25 22 22 22 22 22 22 22 22 22 17 17 17 17 17 17
25 25 25 25 25 25 25 25 25 25 22 22 22 22 22 22 22 22 22 17 17 17 17 17 17
25 25 25 25 25 25 25 25 25 25 22 22 22 22 22 22 22 22 22 17 17 17 17 17 17
25 25 25 25 25 25 25 25 25 25 22 22 22 22 22 22 22 22 22 17 17 17 17 17 17
25 25 25 25 25 25 25 25 25 25 22 22 22 22 22 22 22 22 22 17 17 17 17 17 17
25 25 25 25 25 25 25 25 25 25 22 22 22 22 22 22 22 22 22 17 17 17 17 17 17
25 25 25 25 25 25 25 25 25 22 22 22 22 22 22 22 22 22 22 17 17 17 17 17 17