21 20
15 15 15 15 15 15 15 15 15 15 15 15 15 15 15 15 15 15 15 15 15
15 15 15 15 15 1 3 37 1 28 14 24 1 8 1 1 15 15 15 15 15
15 15 15 15 15 1 5 5 5 5 5 5 5 5 5 1 15 15 15 15 15
15 15 15 15 15 1 5 11 5 5 5 5 5 5 5 1 15 15 15 15 15
15 15 15 15 15 1 5 10 5 5 5 5 5 5 5 1 15 15 15 15 15
15 15 15 15 15 1 5 5 5 5 5 5 5 5 5 1 15 15 15 15 15
15 15 15 15 15 1 5 5 5 5 5 5 5 5 5 1 15 15 15 15 15
15 15 15 15 15 1 5 5 5 5 5 5 5 5 5 1 15 15 15 15 15
15 15 15 15 15 1 5 5 5 5 5 5 5 5 5 1 15 15 15 15 15
15 15 15 15 15 1 5 5 5 5 5 5 5 5 5 1 15 15 15 15 15
15 15 15 15 15 1 1 1 1 1 26 1 1 1 1 1 15 15 15 15 15
15 15 15 15 15 15 15 15 15 15 15 15 15 15 15 15 15 15 15 15 15
15 15 15 15 15 15 15 15 15 15 15 15 15 15 15 15 15 15 15 15 15
15 15 15 15 15 15 15 15 15 15 15 15 15 15 15 15 15 15 15 15 15
15 15 15 15 15 15 15 15 15 15 15 15 15 15 15 15 15 15 15 15 15
15 15 15 15 15 15 15 15 15 15 15 15 15 15 15 15 15 15 15 15 15
15 15 15 15 15 15 15 15 15 15 15 15 15 15 15 15 15 15 15 15 15
15 15 15 15 15 15 15 15 15 15 15 15 15 15 15 15 15 15 15 15 15
15 15 15 15 15 15 15 15 15 15 15 15 15 15 15 15 15 15 15 15 15
15 15 15 15 15 15 15 15 15 15 15 15 15 15 15 15 15 15 15 15 15