21 20
1 1 1 1 1 1 1 1 1 1 1 1 1 1 1 1 1 1 1 1 1
1 1 1 1 1 0 29 30 0 7 13 8 0 0 0 0 1 1 1 1 1
1 1 1 1 1 0 6 6 6 6 6 6 6 6 6 0 1 1 1 1 1
1 1 1 1 1 0 6 12 6 6 6 6 6 6 6 0 1 1 1 1 1
1 1 1 1 1 0 6 11 6 6 6 6 6 6 6 0 1 1 1 1 1
1 1 1 1 1 0 6 6 6 6 6 6 6 6 6 0 1 1 1 1 1
1 1 1 1 1 0 6 6 6 6 6 6 6 6 6 0 1 1 1 1 1
1 1 1 1 1 0 6 6 6 6 6 6 6 6 6 0 1 1 1 1 1
1 1 1 1 1 0 6 6 6 6 6 6 6 6 6 0 1 1 1 1 1
1 1 1 1 1 0 6 6 6 6 6 6 6 6 6 0 1 1 1 1 1
1 1 1 1 1 0 0 0 0 0 3 0 0 0 0 0 1 1 1 1 1
1 1 1 1 1 1 1 1 1 1 1 1 1 1 1 1 1 1 1 1 1
1 1 1 1 1 1 1 1 1 1 1 1 1 1 1 1 1 1 1 1 1
1 1 1 1 1 1 1 1 1 1 1 1 1 1 1 1 1 1 1 1 1
1 1 1 1 1 1 1 1 1 1 1 1 1 1 1 1 1 1 1 1 1
1 1 1 1 1 1 1 1 1 1 1 1 1 1 1 1 1 1 1 1 1
1 1 1 1 1 1 1 1 1 1 1 1 1 1 1 1 1 1 1 1 1
1 1 1 1 1 1 1 1 1 1 1 1 1 1 1 1 1 1 1 1 1
1 1 1 1 1 1 1 1 1 1 1 1 1 1 1 1 1 1 1 1 1
1 1 1 1 1 1 1 1 1 1 1 1 1 1 1 1 1 1 1 1 1