21 20
15 15 15 15 15 15 15 15 15 15 15 15 15 15 15 15 15 15 15 15 15
15 15 15 15 15 0 36 23 0 30 30 30 0 0 29 0 15 15 15 15 15
15 15 15 15 15 0 4 4 4 4 31 4 4 4 4 0 15 15 15 15 15
15 15 15 15 15 0 4 4 4 4 4 4 4 4 4 0 15 15 15 15 15
15 15 15 15 15 0 4 32 32 32 32 32 32 32 4 0 15 15 15 15 15
15 15 15 15 15 0 4 32 32 32 32 32 32 32 4 0 15 15 15 15 15
15 15 15 15 15 0 4 32 32 32 32 32 32 32 4 0 15 15 15 15 15
15 15 15 15 15 0 4 32 32 32 32 32 32 32 4 0 15 15 15 15 15
15 15 15 15 15 0 4 4 4 4 4 4 4 4 4 0 15 15 15 15 15
15 15 15 15 15 0 4 4 4 4 4 4 4 4 4 0 15 15 15 15 15
15 15 15 15 15 0 0 0 0 0 35 0 0 0 0 0 15 15 15 15 15
15 15 15 15 15 15 15 15 15 15 15 15 15 15 15 15 15 15 15 15 15
15 15 15 15 15 15 15 15 15 15 15 15 15 15 15 15 15 15 15 15 15
15 15 15 15 15 15 15 15 15 15 15 15 15 15 15 15 15 15 15 15 15
15 15 15 15 15 15 15 15 15 15 15 15 15 15 15 15 15 15 15 15 15
15 15 15 15 15 15 15 15 15 15 15 15 15 15 15 15 15 15 15 15 15
15 15 15 15 15 15 15 15 15 15 15 15 15 15 15 15 15 15 15 15 15
15 15 15 15 15 15 15 15 15 15 15 15 15 15 15 15 15 15 15 15 15
15 15 15 15 15 15 15 15 15 15 15 15 15 15 15 15 15 15 15 15 15
15 15 15 15 15 15 15 15 15 15 15 15 15 15 15 15 15 15 15 15 15