17 13
17 17 17 17 17 17 17 17 17 17 17 17 17 17 17 17 17
17 17 17 17 17 17 17 17 17 17 17 17 17 17 17 17 17
17 17 20 18 18 18 18 18 18 18 18 18 18 18 19 17 17
17 20 18 18 18 18 18 18 18 18 18 18 18 18 18 19 17
20 18 18 18 18 18 18 18 18 18 18 18 18 18 18 18 19
25 25 25 25 25 25 25 25 25 25 25 25 25 25 25 25 25
22 22 22 22 22 22 22 22 22 22 22 22 22 22 22 22 22
28 28 28 28 28 28 28 28 28 28 28 28 28 28 28 28 28
27 26 26 26 26 26 26 26 26 26 26 26 26 26 26 26 27
23 22 9 22 23 23 23 23 23 23 23 23 23 22 9 22 23
23 22 9 22 15 15 15 15 15 15 15 15 15 22 9 22 23
23 9 9 9 9 9 9 9 9 9 9 9 9 9 9 9 23
9 24 9 24 15 15 15 15 15 15 15 15 15 24 9 24 9