21 20
1 1 1 1 1 1 1 1 1 1 1 1 1 1 1 1 1 1 1 1 1
1 1 1 1 1 10 10 15 16 28 14 10 21 15 10 10 1 1 1 1 1
1 1 1 1 1 10 26 9 9 9 9 9 36 9 9 10 1 1 1 1 1
1 1 1 1 1 10 35 9 9 9 9 9 9 9 9 10 1 1 1 1 1
1 1 1 1 1 10 9 9 9 9 9 9 9 9 9 10 1 1 1 1 1
1 1 1 1 1 10 26 9 9 9 9 9 9 9 9 10 1 1 1 1 1
1 1 1 1 1 10 35 9 9 9 9 9 9 9 9 10 1 1 1 1 1
1 1 1 1 1 10 9 9 9 9 9 9 9 9 9 10 1 1 1 1 1
1 1 1 1 1 10 26 9 9 9 9 9 9 9 9 10 1 1 1 1 1
1 1 1 1 1 10 35 9 9 9 9 9 9 9 9 10 1 1 1 1 1
1 1 1 1 1 10 10 10 10 10 38 10 10 10 10 10 1 1 1 1 1
1 1 1 1 1 1 1 1 1 1 1 1 1 1 1 1 1 1 1 1 1
1 1 1 1 1 1 1 1 1 1 1 1 1 1 1 1 1 1 1 1 1
1 1 1 1 1 1 1 1 1 1 1 1 1 1 1 1 1 1 1 1 1
1 1 1 1 1 1 1 1 1 1 1 1 1 1 1 1 1 1 1 1 1
1 1 1 1 1 1 1 1 1 1 1 1 1 1 1 1 1 1 1 1 1
1 1 1 1 1 1 1 1 1 1 1 1 1 1 1 1 1 1 1 1 1
1 1 1 1 1 1 1 1 1 1 1 1 1 1 1 1 1 1 1 1 1
1 1 1 1 1 1 1 1 1 1 1 1 1 1 1 1 1 1 1 1 1
1 1 1 1 1 1 1 1 1 1 1 1 1 1 1 1 1 1 1 1 1