17 13
33 33 33 35 32 34 34 34 10 31 17 17 17 17 17 17 18
21 21 21 21 20 21 21 21 10 0 0 0 2 0 0 0 0
21 21 21 21 21 21 21 21 10 0 0 0 1 0 0 0 0
23 23 23 23 14 23 23 23 10 4 9 11 8 9 9 11 12
24 15 24 24 24 24 24 24 10 6 6 6 6 6 6 16 6
29 29 29 29 29 29 29 29 10 28 28 28 28 28 28 28 28
29 29 29 29 29 29 29 29 10 28 28 28 28 28 28 28 28
29 29 29 29 29 29 29 29 10 28 28 28 28 28 28 28 28
29 29 29 29 29 29 29 29 10 28 28 28 28 28 28 28 28
29 29 29 29 29 29 29 29 10 28 28 28 28 28 28 28 28
29 29 29 29 29 29 29 29 10 28 28 28 28 28 28 28 28
29 29 29 29 29 29 29 29 10 28 28 28 28 28 28 28 28
29 29 29 29 29 29 29 29 10 28 28 28 28 28 28 28 28