17 13
2 2 2 2 2 2 0 0 2 14 14 16 16 16 16 16 14
2 2 2 2 2 2 2 0 0 14 14 16 20 16 16 16 14
2 2 2 2 2 2 0 2 0 14 1 16 16 16 16 16 14
2 2 2 2 2 2 0 2 0 14 14 14 14 14 14 14 14
2 2 2 2 2 2 0 0 2 0 0 0 0 0 0 0 0
2 2 2 2 2 0 0 2 2 2 0 0 0 0 0 0 0
2 2 2 2 2 2 2 0 0 2 0 0 0 0 0 0 0
2 2 2 2 2 2 0 0 2 0 0 0 0 0 0 0 0
2 2 2 2 2 2 2 0 0 2 0 0 0 0 0 0 0
2 2 2 2 2 2 0 2 0 2 0 0 0 0 0 0 0
2 2 2 2 2 0 2 2 0 2 0 0 0 0 0 0 0
2 2 2 2 2 2 0 0 2 2 0 0 0 0 0 0 0
2 2 2 2 2 0 2 2 2 0 0 0 0 0 0 0 0