17 13
2 2 2 2 2 2 2 2 2 2 0 0 0 18 19 0 0
2 2 2 2 2 2 2 2 2 2 0 0 0 20 16 0 0
2 2 2 2 2 2 2 2 2 2 0 0 1 16 16 0 0
2 2 4 4 2 2 2 2 2 2 0 0 0 0 0 0 0
2 4 13 13 4 2 2 2 2 2 0 0 0 0 0 0 0
2 2 2 2 2 0 0 2 2 2 0 0 0 0 0 0 0
2 2 2 2 2 2 2 0 0 2 0 0 0 0 0 0 0
2 2 2 2 2 2 0 0 2 0 0 0 0 0 0 0 0
2 2 2 2 2 2 2 0 0 2 0 0 0 0 0 0 0
2 2 2 2 2 2 0 2 0 2 0 0 0 0 0 0 0
2 2 2 2 2 0 2 2 0 2 0 0 0 0 0 0 0
2 2 2 2 2 2 0 0 2 2 0 0 0 0 0 0 0
2 2 2 2 2 0 2 2 2 0 0 0 0 0 0 0 0