18 18
24 24 24 24 24 24 24 24 24 24 24 24 24 24 24 24 24 24
24 24 24 24 24 24 24 24 24 24 24 24 24 24 24 24 24 24
24 24 24 24 24 24 24 24 24 24 24 24 24 24 24 24 24 24
24 24 24 24 24 24 24 24 24 24 24 24 24 24 24 24 24 24
24 24 24 24 0 1 14 0 2 25 0 15 3 0 24 24 24 24
24 24 24 24 0 4 6 6 6 6 6 6 23 0 24 24 24 24
24 24 24 24 0 5 6 6 6 6 6 6 10 0 24 24 24 24
24 24 24 24 0 22 6 7 8 6 6 6 19 0 24 24 24 24
24 24 24 24 0 16 6 12 13 6 6 6 17 0 24 24 24 24
24 24 24 24 0 6 6 6 6 6 6 6 6 0 24 24 24 24
24 24 24 24 0 6 6 6 6 6 6 6 6 0 24 24 24 24
24 24 24 24 0 6 6 6 6 6 6 11 6 0 24 24 24 24
24 24 24 24 0 6 6 6 6 6 6 6 6 0 24 24 24 24
24 24 24 24 0 0 0 0 0 0 0 0 0 0 24 24 24 24
24 24 24 24 24 24 24 24 24 24 24 24 24 24 24 24 24 24
24 24 24 24 24 24 24 24 24 24 24 24 24 24 24 24 24 24
24 24 24 24 24 24 24 24 24 24 24 24 24 24 24 24 24 24
24 24 24 24 24 24 24 24 24 24 24 24 24 24 24 24 24 24