30 30
23 23 23 23 23 23 23 23 23 23 23 23 23 23 23 23 23 23 23 23 23 23 23 23 23 23 23 23 23 23
23 23 23 23 23 23 23 23 23 23 23 23 23 23 23 23 23 23 23 23 23 23 23 23 23 23 23 23 23 23
23 23 23 23 23 23 23 2 23 23 28 28 28 28 28 28 28 28 28 28 23 23 2 23 23 23 23 23 23 23
23 23 23 23 23 23 23 23 23 23 27 26 27 26 27 27 26 27 26 27 23 23 23 23 23 23 23 23 23 23
23 23 23 23 23 23 23 2 23 23 23 22 3 1 23 23 1 3 22 23 23 23 2 23 23 23 23 23 23 23
23 23 23 23 23 23 23 23 23 23 23 22 3 22 3 3 22 3 22 23 23 23 23 23 23 23 23 23 23 23
9 9 9 9 9 7 9 3 9 0 23 23 23 23 3 3 23 23 23 23 0 9 3 7 9 9 9 7 9 9
6 6 6 6 6 6 6 6 6 4 9 23 3 23 9 9 23 3 23 9 4 6 6 6 6 6 6 6 6 6
17 17 17 17 17 17 17 17 17 29 9 23 3 23 3 3 23 3 23 9 29 17 17 17 17 17 17 17 17 17
17 17 17 17 17 17 17 17 17 29 29 23 9 23 3 3 23 9 23 29 29 17 17 17 17 17 17 17 17 17
17 17 17 17 17 17 17 17 17 29 29 29 9 23 9 9 23 9 29 29 29 17 17 17 17 17 17 17 17 17
17 17 17 17 17 17 17 17 17 17 29 29 29 29 29 29 29 29 29 29 17 17 17 17 17 17 17 17 17 17
17 17 17 17 17 17 17 17 17 17 17 29 29 29 29 29 29 29 29 17 17 17 17 19 19 19 19 19 17 17
17 17 17 17 17 17 17 17 17 17 17 17 17 17 29 29 17 17 17 17 17 17 17 0 0 0 0 0 17 17
17 17 17 17 17 17 17 17 17 17 17 17 17 17 29 29 17 17 17 17 17 17 17 9 7 3 9 9 17 17
17 17 17 17 17 17 17 17 17 17 17 17 17 17 29 29 17 17 17 17 17 17 17 6 16 6 6 6 17 17
29 29 29 29 29 29 29 29 29 29 29 29 29 29 29 29 29 29 29 29 29 29 29 29 29 29 29 29 29 29
29 29 29 29 29 29 29 29 29 29 29 29 29 29 29 29 29 29 29 29 29 29 29 29 29 29 29 29 29 29
17 17 17 17 17 17 17 17 17 17 17 17 17 17 29 29 17 17 17 17 17 17 17 17 17 17 17 17 17 17
17 17 17 17 17 17 17 17 17 17 17 17 17 17 29 29 17 17 17 17 17 17 17 17 17 17 17 17 17 17
17 17 19 19 19 19 19 17 17 17 17 17 17 17 29 29 17 17 17 17 17 17 17 19 19 19 19 19 17 17
17 17 9 9 9 9 9 17 17 17 17 17 17 17 29 29 17 17 17 17 17 17 17 5 5 5 5 5 17 17
17 17 9 7 9 9 9 17 17 17 17 17 17 17 29 29 17 17 17 17 17 17 17 9 9 7 9 9 17 17
17 17 6 6 6 30 6 17 17 17 17 17 17 17 29 29 17 17 17 17 17 17 17 30 6 6 6 6 17 17
29 29 29 29 29 29 29 29 29 29 29 29 29 29 29 29 29 29 29 29 29 29 29 29 29 29 29 29 29 29
29 29 29 29 29 29 29 29 29 29 29 29 29 29 29 29 29 29 29 29 29 29 29 29 29 29 29 29 29 29
17 17 17 17 17 17 17 17 17 17 17 17 17 17 29 29 17 17 17 17 17 17 17 17 17 17 17 17 17 17
17 17 17 17 17 17 17 17 17 17 17 17 17 17 29 29 17 17 17 17 17 17 17 17 17 17 17 17 17 17
17 17 17 17 17 17 17 17 17 17 17 17 17 17 29 29 17 17 17 17 17 17 17 17 17 17 17 17 17 17
17 17 17 17 17 17 17 17 17 17 17 17 17 17 29 29 17 17 17 17 17 17 17 17 17 17 17 17 17 17