17 13
0 1 14 0 0 0 0 0 0 0 0 0 0 2 15 3 0
0 4 6 22 6 6 6 6 6 6 6 6 6 19 6 23 0
0 5 6 16 6 6 6 6 6 6 6 6 6 17 6 10 0
0 6 6 6 6 6 6 6 6 6 6 6 6 6 6 6 0
0 6 6 6 6 6 6 6 6 6 6 6 6 6 6 6 0
0 6 6 6 7 8 6 6 6 6 6 6 6 6 6 6 0
0 6 6 6 12 13 6 6 6 6 6 11 6 6 6 6 0
0 6 6 6 6 6 6 6 6 6 6 6 6 6 6 6 0
0 6 6 6 6 6 6 6 6 6 6 6 6 6 6 6 0
0 6 6 6 6 6 6 6 6 6 6 6 6 6 6 6 0
0 6 6 6 6 6 6 6 6 6 6 6 6 6 6 6 0
0 6 6 6 6 6 6 6 6 6 6 6 6 6 6 6 0
0 0 0 0 0 0 0 0 0 0 0 0 0 0 0 0 0