18 18
24 24 24 24 24 24 24 24 24 24 24 24 24 24 24 24 24 24
24 24 24 24 24 24 24 24 24 24 24 24 24 24 24 24 24 24
24 24 24 24 24 24 24 24 24 24 24 24 24 24 24 24 24 24
24 24 24 24 24 24 24 24 24 24 24 24 24 24 24 24 24 24
24 24 24 24 0 1 0 0 2 25 0 0 29 0 24 24 24 24
24 24 24 24 0 4 6 6 6 6 6 6 9 0 24 24 24 24
24 24 24 24 0 5 6 6 6 6 6 6 10 0 24 24 24 24
24 24 24 24 0 19 6 7 8 6 6 6 18 0 24 24 24 24
24 24 24 24 0 16 6 12 13 6 6 6 17 0 24 24 24 24
24 24 24 24 0 6 6 6 6 6 6 6 6 0 24 24 24 24
24 24 24 24 0 6 6 6 6 6 6 28 6 0 24 24 24 24
24 24 24 24 0 6 6 6 6 6 6 6 6 0 24 24 24 24
24 24 24 24 0 6 6 6 6 6 6 6 6 0 24 24 24 24
24 24 24 24 0 0 0 0 26 0 0 0 0 0 24 24 24 24
24 24 24 24 24 24 24 24 24 24 24 24 24 24 24 24 24 24
24 24 24 24 24 24 24 24 24 24 24 24 24 24 24 24 24 24
24 24 24 24 24 24 24 24 24 24 24 24 24 24 24 24 24 24
24 24 24 24 24 24 24 24 24 24 24 24 24 24 24 24 24 24