30 30
5 5 5 5 5 5 5 5 5 5 25 25 25 25 25 25 25 25 25 25 0 5 5 5 5 5 5 5 5 5
0 0 0 0 0 0 0 1 0 0 22 22 22 22 22 22 22 22 22 22 0 0 1 0 0 0 0 0 0 0
0 0 0 0 0 0 0 3 0 0 28 28 28 28 28 28 28 28 28 28 0 0 3 0 0 0 0 0 0 0
0 0 0 0 0 0 0 1 0 0 26 26 26 26 26 26 26 26 26 26 0 0 1 0 0 0 0 0 0 0
0 0 0 0 0 0 0 2 0 0 23 22 15 22 23 23 22 15 22 23 0 0 3 0 0 0 0 0 0 0
1 1 1 1 1 1 1 1 1 1 23 22 15 22 15 15 22 15 22 23 1 1 1 1 1 1 1 1 1 1
9 11 9 4 9 13 9 7 9 9 23 24 23 24 15 15 24 23 24 23 9 9 8 12 14 9 4 9 9 10
6 6 6 6 6 6 6 6 6 16 9 24 15 24 9 9 24 15 24 9 30 6 6 6 6 6 6 6 6 6
17 17 17 17 17 17 17 17 17 29 9 24 15 24 15 15 24 15 24 9 29 17 17 17 17 17 17 17 17 17
17 17 17 17 17 17 17 17 17 29 29 24 9 24 15 15 24 9 24 29 29 17 17 17 17 17 17 17 17 17
17 17 17 17 17 17 17 17 17 29 29 29 9 24 9 9 24 9 29 29 29 17 17 17 17 17 17 17 17 17
17 17 17 17 17 17 17 17 17 17 29 29 29 29 29 29 29 29 29 29 17 17 17 17 20 18 19 17 17 17
17 17 17 17 17 17 17 17 17 17 17 29 29 29 29 29 29 29 29 17 17 17 17 20 18 18 18 19 17 17
17 17 17 17 17 17 17 17 17 17 17 17 17 17 29 29 17 17 17 17 17 17 17 0 0 1 0 0 17 17
17 17 17 17 17 17 17 17 17 17 17 17 17 17 29 29 17 17 17 17 17 17 17 9 12 7 9 9 17 17
17 17 17 17 17 17 17 17 17 17 17 17 17 17 29 29 17 17 17 17 17 17 17 6 16 6 6 6 17 17
29 29 29 29 29 29 29 29 29 29 29 29 29 29 29 29 29 29 29 29 29 29 29 29 29 29 29 29 29 29
29 29 29 29 29 29 29 29 29 29 29 29 29 29 29 29 29 29 29 29 29 29 29 29 29 29 29 29 29 29
17 17 17 17 17 17 17 17 17 17 17 17 17 17 29 29 17 17 17 17 17 17 17 17 17 17 17 17 17 17
17 17 17 20 18 19 17 17 17 17 17 17 17 17 29 29 17 17 17 17 17 17 17 17 20 18 19 17 17 17
17 17 20 18 18 18 19 17 17 17 17 17 17 17 29 29 17 17 17 17 17 17 17 20 18 18 18 19 17 17
17 17 9 9 9 9 9 17 17 17 17 17 17 17 29 29 17 17 17 17 17 17 17 0 0 0 0 0 17 17
17 17 13 9 9 9 9 17 17 17 17 17 17 17 29 29 17 17 17 17 17 17 17 9 9 12 9 9 17 17
17 17 9 10 9 30 11 17 17 17 17 17 17 17 29 29 17 17 17 17 17 17 17 16 6 6 11 6 17 17
29 29 29 29 29 29 29 29 29 29 29 29 29 29 29 29 29 29 29 29 29 29 29 29 29 29 29 29 29 29
29 29 29 29 29 29 29 29 29 29 29 29 29 29 29 29 29 29 29 29 29 29 29 29 29 29 29 29 29 29
17 17 17 17 17 17 17 17 17 17 17 17 17 17 29 29 17 17 17 17 17 17 17 17 17 17 17 17 17 17
17 17 17 17 17 17 17 17 17 17 17 17 17 17 29 29 17 17 17 17 17 17 17 17 17 17 17 17 17 17
17 17 17 17 17 17 17 17 17 17 17 17 17 17 29 29 17 17 17 17 17 17 17 17 17 17 17 17 17 17
17 17 17 17 17 17 17 17 17 17 17 17 17 17 29 29 17 17 17 17 17 17 17 17 17 17 17 17 17 17