30 30
14 14 14 14 14 14 14 14 14 14 14 2 2 2 2 14 14 14 14 14 14 14 14 14 14 14 14 14 14 14
14 14 14 14 14 14 14 14 14 14 14 2 2 2 2 14 14 14 14 14 14 14 14 14 14 14 14 14 14 14
14 14 14 14 14 14 14 14 14 14 14 2 2 2 2 14 14 14 14 14 14 14 14 14 14 14 14 14 14 14
14 14 14 14 14 14 14 14 14 14 14 2 2 2 2 14 14 14 14 14 14 14 14 14 14 14 14 14 14 14
14 14 14 14 0 0 0 14 14 14 14 2 2 2 2 14 14 14 14 14 14 14 14 14 14 14 14 14 14 14
14 14 14 0 0 17 0 0 14 14 14 2 2 2 2 14 14 14 14 14 14 14 14 14 14 14 14 14 14 14
0 0 0 0 18 17 19 0 0 0 0 2 2 2 2 14 14 14 14 14 14 14 14 14 14 14 14 14 14 14
15 15 0 18 20 17 20 19 0 15 15 2 2 2 2 14 14 14 14 14 14 14 14 14 14 14 14 14 14 14
15 15 18 17 17 17 17 17 19 15 15 2 2 2 2 14 14 14 14 14 14 14 14 14 14 14 14 14 14 14
0 18 17 17 17 17 17 17 17 19 0 2 2 2 2 14 14 14 14 14 0 0 0 0 14 14 14 14 14 14
18 17 17 17 17 17 17 17 17 17 19 2 2 2 2 14 14 14 14 0 0 18 19 0 0 0 0 14 14 14
16 20 20 16 16 16 16 16 20 20 16 2 2 2 2 0 0 0 0 0 18 17 17 19 0 0 0 14 14 14
16 20 20 16 16 16 16 16 20 20 16 2 2 2 2 0 0 0 0 18 17 17 17 17 19 0 0 14 14 14
16 16 16 16 16 16 16 16 16 16 16 2 2 2 2 0 9 10 0 16 16 16 16 16 16 0 0 14 14 14
16 20 20 16 16 16 16 16 20 20 16 2 2 2 2 0 10 9 0 16 16 16 16 16 16 0 0 14 14 14
16 16 16 16 22 22 22 16 16 16 16 1 2 2 2 0 0 0 0 16 16 16 22 16 16 1 0 14 14 14
2 2 2 2 2 2 2 2 2 2 2 2 2 2 2 2 2 2 2 2 2 2 2 2 2 2 2 2 2 2
2 2 2 2 2 2 2 2 2 2 2 2 2 2 2 2 2 2 2 2 2 2 2 2 2 2 2 2 2 2
2 2 2 2 2 2 2 2 2 2 2 2 2 2 2 2 2 2 2 2 2 2 2 2 2 2 2 2 2 2
2 2 2 2 2 2 2 2 2 2 2 2 2 2 2 2 2 2 2 2 2 2 2 2 2 2 2 2 2 2
14 14 14 14 14 14 14 14 14 14 14 2 2 2 2 14 14 0 0 18 19 0 0 14 14 14 14 14 14 14
14 14 14 14 0 0 0 14 14 14 14 2 2 2 2 14 0 0 18 17 17 19 0 0 14 14 14 14 14 14
14 14 0 0 18 19 0 0 14 14 14 2 2 2 2 14 0 18 17 17 17 17 19 0 14 14 14 14 14 14
14 14 0 18 17 17 19 0 14 14 14 2 2 2 2 14 0 16 16 16 16 16 16 0 14 14 14 14 14 14
14 14 0 16 16 16 16 0 14 14 14 2 2 2 2 14 0 16 16 21 20 16 16 0 14 14 14 14 14 14
14 14 0 16 20 21 16 0 14 14 14 2 2 2 2 14 0 16 16 21 20 16 16 0 14 14 14 14 14 14
14 14 0 16 16 22 16 1 2 2 2 2 2 2 2 2 0 16 16 16 16 22 16 1 14 14 14 14 14 14
14 14 0 0 0 0 0 0 2 2 2 2 2 2 2 2 0 0 0 0 0 0 0 0 14 14 14 14 14 14
14 14 14 14 14 14 14 2 2 2 2 2 2 2 2 2 14 14 14 14 14 14 14 14 14 14 14 14 14 14
14 14 14 14 14 14 14 14 14 14 14 2 2 2 2 14 14 14 14 14 14 14 14 14 14 14 14 14 14 14