30 30
8 8 8 0 8 8 8 3 0 0 0 14 14 14 14 0 0 8 8 8 0 3 0 0 0 0 0 0 0 0
8 8 8 0 8 8 8 0 0 3 0 14 14 14 14 0 0 8 8 8 0 0 0 8 8 8 0 0 0 0
8 8 8 3 0 7 0 3 0 0 0 14 14 14 14 3 0 8 8 8 0 3 0 8 8 8 0 3 0 0
0 7 0 0 0 7 0 0 0 0 0 14 14 14 14 0 0 0 7 0 0 0 0 8 8 8 0 0 0 0
0 4 0 3 0 0 0 0 0 3 0 14 14 14 14 0 0 0 0 0 0 0 0 0 7 0 0 0 0 0
0 7 0 0 0 17 0 0 0 0 0 14 14 14 14 0 3 0 0 0 0 0 0 0 7 0 0 0 0 0
0 0 0 0 18 17 19 0 0 0 0 14 14 14 14 0 0 0 0 0 0 0 3 0 7 0 0 0 0 0
15 15 0 18 20 17 20 19 0 15 15 14 14 14 14 0 0 0 0 0 0 0 0 0 0 0 0 0 0 0
15 15 18 17 17 17 17 17 19 15 15 14 14 14 14 0 0 0 0 0 0 0 0 0 3 0 0 0 0 0
0 18 17 17 17 17 17 17 17 19 0 14 14 14 14 0 0 3 0 0 0 0 0 0 0 0 0 0 0 0
18 17 17 17 17 17 17 17 17 17 19 14 14 14 14 0 0 0 0 0 0 18 19 0 0 0 0 0 0 0
16 20 20 16 16 16 16 16 20 20 16 14 14 14 14 0 0 0 0 0 18 17 17 19 0 0 0 0 0 0
16 20 20 16 16 16 16 16 20 20 16 14 14 14 14 0 0 0 0 18 17 17 17 17 19 0 0 0 0 0
16 16 16 16 16 16 16 16 16 16 16 14 14 14 14 0 9 10 0 16 16 16 16 16 16 0 0 0 0 0
16 20 20 16 16 16 16 16 20 20 16 14 14 14 14 0 10 9 0 16 16 16 16 16 16 0 0 0 0 0
16 16 16 16 22 22 22 16 16 16 16 1 14 14 14 0 0 0 0 16 16 16 22 16 16 1 0 0 0 0
14 14 14 14 14 14 14 14 14 14 14 14 14 14 14 14 14 14 14 14 14 14 14 14 14 14 14 14 14 14
14 14 14 14 14 14 14 14 14 14 14 14 14 14 14 14 14 14 14 14 14 14 14 14 14 14 14 14 14 14
14 14 14 14 14 14 14 14 14 14 14 14 14 14 14 14 14 14 14 14 14 14 14 14 14 14 14 14 14 14
14 14 14 14 14 14 14 14 14 14 14 14 14 14 14 14 14 14 14 14 14 14 14 14 14 14 14 14 14 14
14 14 14 14 14 14 14 14 14 14 14 14 14 14 14 14 14 14 14 14 14 14 14 14 14 14 14 14 14 14
0 0 0 0 0 0 0 0 0 0 0 2 14 14 14 0 0 0 0 0 0 0 0 0 0 0 0 0 0 0
0 0 0 5 11 11 11 6 0 0 0 14 14 2 14 0 0 0 13 0 13 0 13 0 0 13 0 0 0 0
0 0 13 0 0 0 0 13 0 0 0 2 14 14 2 0 0 0 0 0 0 0 0 0 0 0 0 0 0 0
0 0 0 13 0 0 0 0 0 0 0 2 14 2 2 0 0 5 6 0 0 0 0 0 13 0 0 0 0 0
0 0 0 0 0 0 0 0 0 13 0 14 2 14 14 0 0 0 0 0 0 0 13 0 0 0 0 0 0 0
0 5 11 11 6 0 0 0 0 0 0 2 2 2 2 0 0 0 0 0 0 0 0 0 0 0 0 0 0 0
0 0 13 0 0 0 0 0 0 0 0 14 2 14 2 0 0 0 0 13 13 0 0 0 0 13 0 0 0 0
2 2 2 2 2 2 2 2 2 2 2 2 2 2 2 2 2 2 2 2 2 2 2 2 2 2 2 2 2 2
23 23 23 23 23 23 23 23 23 23 23 23 23 23 23 23 23 23 23 23 23 23 23 23 23 23 23 23 23 23