30 30
0 0 8 8 8 0 0 0 10 0 0 0 0 0 8 0 0 0 8 8 8 0 0 0 0 0 0 0 0 0
0 0 8 7 8 0 0 0 8 8 8 0 0 8 8 8 0 0 8 7 8 0 0 8 8 8 0 0 0 0
0 10 0 7 0 0 0 8 8 8 8 8 10 0 12 0 0 10 0 7 0 10 0 0 12 0 10 0 0 0
8 8 8 12 0 0 0 8 8 7 8 8 0 0 10 0 0 0 0 12 0 0 9 0 0 0 0 0 0 12
8 7 8 0 0 0 0 8 8 7 8 8 0 0 5 11 11 6 0 0 0 10 0 15 15 0 0 0 0 0
0 7 0 0 0 10 0 0 0 12 0 0 0 0 15 0 15 0 0 9 0 0 10 0 0 0 10 9 0 0
0 12 0 0 0 0 0 0 0 0 8 8 8 0 0 9 5 11 11 11 6 0 0 0 0 0 0 0 0 0
0 8 8 8 0 0 0 0 0 0 8 8 8 0 0 0 0 0 0 0 15 0 10 0 8 0 0 0 0 0
0 8 8 8 0 0 0 10 10 0 8 7 8 0 0 0 0 0 0 0 0 0 0 8 8 8 0 0 0 0
0 8 7 8 0 0 0 0 0 0 8 7 8 0 0 8 8 8 0 0 0 0 0 8 12 8 0 0 0 0
0 0 12 0 0 0 0 0 0 9 0 12 0 9 0 8 8 8 0 9 0 9 0 0 0 0 0 0 0 0
0 0 0 0 5 11 6 0 0 0 0 0 0 0 0 8 8 8 0 0 0 0 0 0 0 0 0 9 0 0
0 0 8 8 8 0 0 0 0 9 0 0 0 9 0 0 7 0 0 0 0 0 10 0 0 0 0 0 0 0
0 0 8 7 8 0 0 0 0 0 0 0 0 0 0 0 12 0 0 9 0 0 0 0 0 0 0 0 0 0
0 0 0 12 0 0 0 10 0 0 0 10 0 0 0 0 0 0 0 0 0 0 0 0 9 0 0 0 0 0
0 0 0 0 0 10 0 0 0 0 5 11 11 11 11 6 0 0 0 0 15 0 0 0 0 0 0 0 0 0
0 0 0 0 0 0 0 0 0 0 0 0 0 0 0 0 0 0 10 0 0 0 0 0 0 0 0 0 0 0
0 10 10 0 0 8 0 0 0 0 0 0 0 0 0 0 0 0 0 0 0 0 9 0 15 0 0 0 0 0
0 0 0 0 8 8 8 0 15 0 0 8 0 0 0 0 0 0 0 7 0 0 0 0 0 0 0 0 0 0
0 0 0 0 8 7 8 0 0 0 8 8 8 0 0 8 8 8 0 7 0 0 0 0 0 0 0 9 0 0
0 0 0 0 0 7 0 15 0 0 8 8 8 0 0 8 8 8 0 7 0 0 0 8 0 0 0 0 0 0
0 0 0 0 0 7 0 0 9 0 8 8 8 0 0 8 7 8 0 7 0 0 8 8 8 0 0 0 8 0
0 0 0 0 0 12 0 0 0 0 0 7 0 0 0 0 7 0 0 12 0 0 0 12 0 0 0 8 8 8
0 0 0 8 8 8 0 0 8 8 8 7 0 0 0 0 12 0 0 0 0 9 0 0 0 0 0 0 12 0
0 0 0 8 8 8 10 0 8 8 8 12 0 0 0 9 0 0 8 0 0 0 0 0 9 0 0 0 0 0
0 0 0 8 8 8 0 0 8 8 8 0 10 0 0 0 0 8 8 8 0 8 0 0 0 15 0 9 15 0
0 0 0 8 8 8 0 0 0 7 0 0 0 0 0 0 0 8 8 8 8 8 8 0 0 0 0 8 0 0
0 0 0 8 8 8 0 15 0 12 0 0 10 9 15 10 0 0 7 0 0 12 0 0 0 10 8 8 8 0
0 0 0 0 12 0 0 10 0 0 0 0 15 0 0 0 0 0 12 0 0 0 0 15 0 0 0 12 0 0
0 0 10 0 0 0 0 0 0 0 0 0 0 0 0 0 15 0 0 0 0 0 10 0 0 0 0 0 0 0